10 10
XXXXXXXXXX
X.X......X
X.XXX2XXXX
X..X...X.X
XX.1.X.X.X
X..X.....X
X.XXX..X.X
X.XX.X.X.X
X....X.X.X
XXXXXXXXXX
